AROUND	ER AW N D
AROUND(2)	ER AW N
CONFIRM	K AH N F ER M
DENY	D IH N AY
DOWN	D AW N
EIGHT	EY T
ELEVATOR	EH L AH V EY T ER
FACE	F EY S
FIVE	F AY V
FOUR	F AO R
GO	G OW
LEFT	L EH F T
ME	M IY
MOVE	M UW V
NINE	N AY N
NO	N OW
OFF	AO F
ONE	W AH N
ONE(2)	HH W AH N
PICK	P IH K
RIGHT	R AY T
ROOM	R UW M
SEVEN	S EH V AH N
SHUT	SH AH T
SIX	S IH K S
STOP	S T AA P
TAKE	T EY K
THREE	TH R IY
TO	T UW
TO(2)	T IH
TO(3)	T AH
TURN	T ER N
TWO	T UW
UP	AH P
YES	Y EH S
ZERO	Z IY R OW
